{
  "id": "level-08",
  "name": "Switch Path",
  "difficulty": 3,
  "grid": [
    [1, 1, 1, 1, 1, 1, 1, 1, 1],
    [1, 0, 0, 0, 0, 0, 0, 2, 1],
    [1, 0, 1, 1, 1, 1, 0, 5, 1],
    [1, 0, 1, 0, 0, 1, 0, 0, 1],
    [1, 0, 1, 0, 4, 1, 0, 0, 1],
    [1, 0, 1, 0, 0, 1, 0, 0, 1],
    [1, 0, 0, 0, 0, 0, 0, 0, 1],
    [1, 0, 0, 0, 0, 0, 0, 0, 1],
    [1, 1, 1, 1, 1, 1, 1, 1, 1]
  ],
  "start": { "x": 1, "y": 7, "dir": 0 },
  "goal": { "x": 7, "y": 1 },
  "objects": {
    "buttons": [{ "id": "A", "x": 4, "y": 4 }],
    "doors": [{ "id": "A", "x": 7, "y": 2, "open": false }]
  }
}
