{
  "id": "level-11",
  "name": "Split Patrol",
  "difficulty": 4,
  "grid": [
    [1, 1, 1, 1, 1, 1, 1, 1, 1, 1],
    [1, 0, 0, 0, 0, 0, 0, 0, 2, 1],
    [1, 0, 1, 1, 1, 1, 0, 1, 1, 1],
    [1, 0, 1, 0, 0, 1, 0, 0, 0, 1],
    [1, 0, 1, 0, 3, 1, 0, 0, 0, 1],
    [1, 0, 1, 0, 0, 1, 0, 0, 0, 1],
    [1, 0, 1, 1, 1, 1, 0, 1, 1, 1],
    [1, 0, 0, 0, 0, 0, 0, 0, 0, 1],
    [1, 0, 0, 0, 0, 0, 0, 0, 0, 1],
    [1, 1, 1, 1, 1, 1, 1, 1, 1, 1]
  ],
  "start": { "x": 1, "y": 8, "dir": 0 },
  "goal": { "x": 8, "y": 1 },
  "robots": [
    { "x": 1, "y": 8, "dir": 0 },
    { "x": 8, "y": 8, "dir": 0 }
  ]
}
