{
  "id": "level-02",
  "name": "Turn the Corner",
  "difficulty": 1,
  "grid": [
    [1, 1, 1, 1, 1, 1, 1, 1],
    [1, 0, 0, 0, 0, 0, 0, 1],
    [1, 0, 1, 1, 1, 1, 0, 1],
    [1, 0, 1, 0, 0, 0, 0, 1],
    [1, 0, 1, 0, 1, 1, 0, 1],
    [1, 0, 0, 0, 1, 2, 0, 1],
    [1, 0, 0, 0, 1, 0, 0, 1],
    [1, 1, 1, 1, 1, 1, 1, 1]
  ],
  "start": { "x": 1, "y": 1, "dir": 2 },
  "goal": { "x": 5, "y": 5 }
}
