{
  "id": "level-06",
  "name": "Hazard Hop",
  "difficulty": 3,
  "grid": [
    [1, 1, 1, 1, 1, 1, 1, 1, 1],
    [1, 0, 0, 0, 0, 0, 0, 2, 1],
    [1, 0, 3, 3, 3, 3, 0, 0, 1],
    [1, 0, 3, 0, 0, 3, 0, 0, 1],
    [1, 0, 3, 0, 0, 3, 0, 0, 1],
    [1, 0, 3, 3, 3, 3, 0, 0, 1],
    [1, 0, 0, 0, 0, 0, 0, 0, 1],
    [1, 0, 0, 0, 0, 0, 0, 0, 1],
    [1, 1, 1, 1, 1, 1, 1, 1, 1]
  ],
  "start": { "x": 1, "y": 7, "dir": 0 },
  "goal": { "x": 7, "y": 1 }
}
