{
  "id": "level-04",
  "name": "Hallway Loop",
  "difficulty": 2,
  "grid": [
    [1, 1, 1, 1, 1, 1, 1, 1, 1],
    [1, 0, 0, 0, 0, 0, 0, 2, 1],
    [1, 0, 1, 1, 1, 1, 0, 1, 1],
    [1, 0, 1, 0, 0, 1, 0, 0, 1],
    [1, 0, 1, 0, 0, 1, 1, 0, 1],
    [1, 0, 0, 0, 0, 0, 1, 0, 1],
    [1, 1, 1, 1, 1, 0, 0, 0, 1],
    [1, 0, 0, 0, 0, 0, 0, 0, 1],
    [1, 1, 1, 1, 1, 1, 1, 1, 1]
  ],
  "start": { "x": 1, "y": 7, "dir": 0 },
  "goal": { "x": 7, "y": 1 }
}
