{
  "id": "level-12",
  "name": "Doorway Finale",
  "difficulty": 5,
  "grid": [
    [1, 1, 1, 1, 1, 1, 1, 1, 1, 1, 1],
    [1, 0, 0, 0, 0, 0, 0, 0, 0, 2, 1],
    [1, 0, 1, 1, 1, 1, 1, 1, 0, 5, 1],
    [1, 0, 1, 0, 0, 0, 0, 1, 0, 0, 1],
    [1, 0, 1, 0, 4, 1, 0, 1, 0, 0, 1],
    [1, 0, 1, 0, 0, 1, 0, 1, 0, 0, 1],
    [1, 0, 1, 0, 0, 1, 0, 1, 0, 0, 1],
    [1, 0, 1, 0, 0, 1, 0, 1, 0, 0, 1],
    [1, 0, 1, 1, 1, 1, 0, 1, 1, 1, 1],
    [1, 0, 0, 0, 0, 0, 0, 0, 0, 0, 1],
    [1, 1, 1, 1, 1, 1, 1, 1, 1, 1, 1]
  ],
  "start": { "x": 1, "y": 9, "dir": 0 },
  "goal": { "x": 9, "y": 1 },
  "objects": {
    "buttons": [{ "id": "C", "x": 4, "y": 4 }],
    "doors": [{ "id": "C", "x": 9, "y": 2, "open": false }]
  },
  "robots": [
    { "x": 1, "y": 9, "dir": 0 },
    { "x": 1, "y": 1, "dir": 2 }
  ]
}
