{
  "id": "level-10",
  "name": "Twin Bots",
  "difficulty": 4,
  "grid": [
    [1, 1, 1, 1, 1, 1, 1, 1, 1],
    [1, 0, 0, 0, 0, 0, 0, 2, 1],
    [1, 0, 1, 1, 1, 1, 0, 0, 1],
    [1, 0, 1, 0, 0, 1, 0, 0, 1],
    [1, 0, 1, 0, 0, 1, 0, 0, 1],
    [1, 0, 1, 1, 1, 1, 0, 0, 1],
    [1, 0, 0, 0, 0, 0, 0, 0, 1],
    [1, 0, 0, 0, 0, 0, 0, 0, 1],
    [1, 1, 1, 1, 1, 1, 1, 1, 1]
  ],
  "start": { "x": 1, "y": 7, "dir": 0 },
  "goal": { "x": 7, "y": 1 },
  "robots": [
    { "x": 1, "y": 7, "dir": 0 },
    { "x": 7, "y": 7, "dir": 0 }
  ]
}
