{
  "id": "level-05",
  "name": "Zigzag Walk",
  "difficulty": 2,
  "grid": [
    [1, 1, 1, 1, 1, 1, 1, 1, 1],
    [1, 0, 0, 1, 0, 0, 1, 2, 1],
    [1, 0, 0, 1, 0, 0, 1, 0, 1],
    [1, 0, 0, 1, 0, 0, 1, 0, 1],
    [1, 0, 0, 0, 0, 0, 0, 0, 1],
    [1, 0, 1, 1, 1, 1, 0, 0, 1],
    [1, 0, 0, 0, 0, 0, 0, 0, 1],
    [1, 0, 0, 0, 0, 0, 0, 0, 1],
    [1, 1, 1, 1, 1, 1, 1, 1, 1]
  ],
  "start": { "x": 1, "y": 7, "dir": 0 },
  "goal": { "x": 7, "y": 1 }
}
